NO ./path_to_the_north_texture.png
SO ./path_to_the_south_texture.png
WE ./path_to_the_west_texture.png
EA ./path_to_the_east_texture.png

C 225,30,100
F 220,100,100

111111111111111111111111111111
1S00000000000000000000000010001
1000000000000001000000001010011
1000000000000000100000000000111
100000000000000100000000111001
1000000000000000000000000000011
111111111111111111111111111111
