NO ./textures/mylittlezelije.png
SO ./textures/mylittlezelije.png
WE ./textures/mylittlezelije.png
EA ./textures/mylittlezelije.png

C 0,0,0
F 0,0,0

111111111111111111111111111111
1S00000000000000000000000010001
1000000000000001000000001010011
1000000100000000100000000000111
100000000000000100000000111001
1000000000000000000000000000011
111111111111111111111111111111

