NO ./path_to_the_north_texture.png
SO ./path_to_the_south_texture.png
WE ./path_to_the_west_texture.png
EA ./path_to_the_east_texture.png

C 225,30,100
F 220,100,100

1111111111111
1111111111111
111110111S1111
11111111111111