NO ./path_to_the_north_texture.png
SO ./path_to_the_south_texture.png
WE ./path_to_the_west_texture.png
EA ./path_to_the_east_texture.png

C 100,10,9
F 255,255,255

1111111111111111111111111
1000000000110000000000001
1011000001110000000000001
10010000000000000000000011111111
111111111011000001110000000000001
100000000011000001110111111111111
11110111011111011100000010001
11110111011111011101010010001
11111111011111111111111111111
11111111011111111111111111111
11000000101010111000000100001
10000000000000001100000010001
10000000000000001101010010001
11000001110101011111011110N0111
11110111 1110101 101111010001
11111111 1111111 11111111111