NO ./mandatory/textures/1.png
SO ./mandatory/textures/2.png
WE ./mandatory/textures/3.png
EA ./mandatory/textures/4.png


F 0,0,0



C 255,255,255

1111111111111111111111111111111111111111111111111111111111111111
100000000000S0000000000000000000000000001
1111111111111111111111111111111111111111111111111111111111111111
10000000000000000000000000000000000000001
10000000000000000000000000000000000000001
10000000000000000000000000000000000000001
10000000000000000000000000000000000000001
10000000000000000000000000000000000000001
1111111111111111111111111111111111111111111111111111111111111111