NO ./mandatory/textures/1.png
SO ./mandatory/textures/2.png
WE ./mandatory/textures/3.png
EA ./mandatory/textures/4.png

C 3,212,255
F ,0,0

11111111111111111111111
10000N00000000000000001
10000000000000000000001
10000001111000000000001
10000001  1000000000001
10000001111000000000001
10000000000000000000001
11111111111111111111111
