NO ./mandatory/textures/1.png
SO ./mandatory/textures/2.png
WE ./mandatory/textures/3.png
EA ./mandatory/textures/4.png

C 178,212,290
F 0,0,0

11111111111111111111111111111111
111111111011000001110000000000001
100000000011000001110000N0001111
11110111111111000000000000001
11110111111111011101110000001
11000000110101011100010000001
10000000000000001100000010001
10000000000000001101010010001
1100000111010101111101111000111
11110111 1110101 101111010001
11111111  1111111 111111111111
