NO ./mandatory/textures/1.png
SO ./mandatory/textures/2.png
WE ./mandatory/textures/3.png
EA ./mandatory/textures/4.png

C 178,212,234
F 0,0,0

11111111111111111111111111111111
111111111011000001110000000000001
100000000011000001110111111111111
11110111111111011100000010001
11110111111111011101010010001
11000000110101011100000010001
10000000000000001100000010001
10000000000000001101010010001
11000001110101011111011110N0111
11110111 1110101 101111010001
11111111  1111111 111111111111
