NO ./bonus/textures/1.png
SO ./bonus/textures/2.png
WE ./bonus/textures/3.png
EA ./bonus/textures/4.png
DR ./bonus/textures/door.png



F 100,0,0
C 0,0,0

1111111111111111111111111111111
1000000000000000000000000000001
1000000000000000100000000000001
1000000000W00000100000000000001
10000000000000000100000000000001
1000000000000000100000000000001
1000000000000000000000000000001
1111111111111111111111111111111