NO ./bonus/textures/1.png
SO ./bonus/textures/2.png
WE ./bonus/textures/3.png
EA ./bonus/textures/4.png
DR ./bonus/textures/door.png


C 178,212,234
F 0,0,0

1111111111111111111111111
10000000000000D0000000001
100S000000000010000000001
1111111111111111111111111