NO ./bonus/textures/1.png
SO ./bonus/textures/2.png
WE ./bonus/textures/3.png
EA ./bonus/textures/4.png
DR ./bonus/textures/door.png


C 178,212,234
F 0,0,0

11111111111111111111111111111111111111111111111111111111111111111111111111
1D1000000011000001110000000000000010000000000001001111110000100000000000001
1S000000000D000001110000000000001010000000000001001111110000100000000000001
100000000011000001110000000000001010000000000001001111110000100000000000001
10000000001100000111000000000000000000000000001001111110000100000000000001
100000000011000001110000000000001010000000000001001111110000100000000000001
100000000011000001110000000000001D10000000000001001111110000100000000000001
100000000011000000010000000000001010000000000001001111110000100000000000001
10000000001100000100000000000010100000000000010011111100001000000000000011
1000000000110000011100000000000010100000000000010011111000001000000000000011
100000000011000001110000000011111D111111111100000100111D110000100000000000001
1000000000110000011100000000000010100000000000010011111000001000000000000011
100000000011000001110000000000001010000000000001001111110000100000000000001
100000000011000001110000000000001010000000000001001111110000100000000000001
100000000011000001110000000000001010000000000001001111110000100000000000001
11111111111111111111111111111111111111111111111111111111111111111111111111 