NO ./bonus/textures/1.png
SO ./bonus/textures/2.png
WE ./bonus/textures/3.png
EA ./bonus/textures/4.png
DR ./bonus/textures/door.png



C 255,255,255
F 0,0,0

1111111111111111111111111111111111111111111111111111111111111111
100000000000S000000000000000000000000000000000000000000000000001
1111111111111111111111111111111111111111111111111111111111111111