NO ./bonus/textures/1.png
SO ./bonus/textures/2.png
WE ./bonus/textures/3.png
EA ./bonus/textures/4.png
DR ./bonus/textures/door1.png


F 48,40,47
C 0,0,0

1111111111111111111111111                                                                   
100000000110000000000001                                                                   1111111111111111111111111       
1011000001110000000000001                                                                   1000000000110000000000001
1001000000000000000000001                                                                   101100000111000000000000111111111111
11111111101100000111000000000000101                                                                   100100000000000000000000111111111
10000000001100000111011111111111111                                                                   111111111011000001110000000000001
11110111111111011100000010001                                                                   100000000011000001110111111111111111111
1111011111111101110101001000111111111111111111111111111111111111111111111111111111111111111111111011111111101110000001000111111111111111
1100000011010101110000001000D0000000000000000000000000000000000000000000000000000000000000000000000000000011101010010001111111111
100000000000000011000000100011111111111111111111111111111111111111111111111111111111111111111111111000000110101011100000010000000111
10000000000000001101010010001                                                                   100000000000000011000000100011111
11000001110101011111011110N0111                                                                   10000000000000001101010010001
11110111 1110101 101111010001                                                                   110000011101010111110111100111
11111111 1111111 111111111111                                                                   11111111 1111111 1
