NO ./bonus/textures/1.png
SO ./bonus/textures/2.png
WE ./bonus/textures/3.png
EA ./bonus/textures/4.png
DR ./bonus/textures/door.png


C 178,212,234
F 0,0,0

11111111111111111111111
10000N00000000000000001
10000000000000000000001111
100000011D1100000000000001
10000001101100000000000001
10000001101100000000000001
10000001101100000000000001
10000001101100000000000001
10000001101100000000000001
100000011D1100000000000001
10000000000000000000001111111111111111111111111111111111
11111111111111111111111
